1 find a @poi_type_1 that is open near me	@poi_11 , @poi_12 , and @poi_13 are all near
2 what has the least traffic ?	@poi_11 has @traffic_info_11
3 what is the address ?	@poi_address_11 , we are @distance_11 away , i sent its position on your screen
4 thanks so much for your help	you are welcome have a good day

1 get the address to the closest @poi_type_1 asap	@poi_11 is the closest @poi_type_1 at @distance_11 and the address is @poi_address_11
2 thanks !	you are welcome

1 find @poi_type_1	there is a @poi_11 @distance_11 away
2 what is the address ?	@poi_11 is at @poi_address_11
3 pick a route to avoid all @traffic_info_10 and let s go there , thank you !	setting route for minimum traffic to @poi_11 now
4 thank you car !	you are welcome !

1 search for nearby @poi_type_1	there is @poi_11 @distance_11 away and a couple of other farther options
2 which is the best one with the quickest route ?	the would be @poi_11
3 can i get the address ?	@poi_11 is at @poi_address_11
4 cool , thanks	have a great day

1 where is a close @poi_type_1 ?	@poi_11 is @distance_11 away
2 what is the address ?	@poi_11 is located at @poi_address_11
3 thanks set the navigation to there please	you are welcome , i set the navigation

1 can you give me directions to the nearest @poi_type_1	the nearest @poi_type_1 is @poi_11 which is @distance_11 away at @poi_address_11
2 that s good , pick a route to avoid all @traffic_info_10 please	there is @traffic_info_11 in this moment , i ve set the navigation there
3 thanks for your help	no problem

1 please give me an address and directions via the fastest route to a @poi_type_1	the closest @poi_type_1 is @poi_11 on @poi_address_11 there is @traffic_info_11 on the way , but it is only @distance_11 away so it should be quick
2 then pick the fastest route for me , please !	i sent the info on your screen , drive carefully !
3 thank you	you are welcome

1 i need @poi_type_1	i have a listing for a place that serves @poi_type_1 that is @distance_11 away
2 what is the address ?	@poi_11 is located at @poi_address_11
3 sounds awesome , thanks	no problem
4 thanks again	you are welcome

1 get me directions to the nearest @poi_type_1	@distance_11 away there is @traffic_info_11 the @poi_11 located at @poi_address_11
2 ok , please direct me there via a route that avoids all @traffic_info_10 if possible	there is @traffic_info_11 in the area , but we drive around that
3 please display the route on the gps	gps set have a great day

1 car i need to get to a @poi_type_1 : is there any around me ?	@poi_11 is @distance_11 away
2 could you please pick a route to avoid all @traffic_info_10 ?	actually there isn t any traffic on our way , enjoy your trip !
3 please give me an address and directions by the route that avoids @traffic_info_10 thank you	setting navigation to @poi_11 now
4 thank you car !	you are welcome ; drive safely

1 whats the nearest @poi_type_1 to me , and i need the quickest route	@poi_11 is the nearest @poi_type_1 but it has @traffic_info_11 on route
2 where is it located ?	@poi_11 is at @poi_address_11
3 set gps for quickest possible route please	setting gps for quickest route now
4 thanks	you are welcome

1 take me to a @poi_type_1	there is a @poi_11 @distance_11 away would you like the address to it ?
2 yes please give me the details of this location	@poi_11 is located at @poi_address_11 , @distance_11 away
3 please give me the fastest route	there is @traffic_info_11 now but you should be able to get there in a few minutes
4 please direct me there thanks	navigating to @poi_address_11 now

1 find me a @poi_type_1	the closest is @poi_11 , @distance_11 away in @traffic_info_11 would you like directions there ?
2 yes , what s the address ?	the address is @poi_address_11 setting navigation now
3 thanks for directing me via the route with least traffic	you are welcone

1 find me a @poi_type_1	we are @distance_11 away from @poi_11
2 give me the address	the address is @poi_address_11 , i sent it on your map there is @traffic_info_11
3 thank you very much car !	you are welcome !

1 get me directions to the @poi_type_1	@poi_address_11 is the address for @poi_11 which is @distance_11 away
2 give me the route with @traffic_info_10 please	there is a @traffic_info_11 but this is the only route i can find to the @poi_11
3 ok , that s fine so long as its via the quickest available route	setting gps , we will be there shortly

1 take me to the nearest @poi_type_1 please	the nearest @poi_11 is @distance_11 away would you like to know the address ?
2 yes , please , send the address on my screen and pick the quickest route for me !	the address is @poi_address_11 , i sent it on your screen , and we are on a route with @traffic_info_11 , enjoy your trip !
3 thank you car , you rock !	so do you driver , goodbye

1 take me to the nearest @poi_type_1	that would be @poi_11 , which is at @poi_address_11
2 thanks	you are welcome

1 find me a place where i could find @poi_type_1	there is a @poi_11 and @poi_12 nearby
2 which is within @distance_11 ?	@poi_11 is @distance_11 away
3 set the navigation for there thanks	you are welcome , navigation set

1 take me to the closest @poi_type_1	we are @distance_11 away from @poi_11 and there is @traffic_info_11 on our way
2 what is the address ?	@poi_11 is at @poi_address_11
3 thank you	glad i could help

1 car i wanna go to a @poi_type_1 !	sure ! we are @distance_12 away from @poi_12 and @distance_11 away from @poi_11 : which one do you prefer ?
2 which has less traffic ?	@poi_11 is the best option available at @poi_address_11 with @traffic_info_11 noted
3 ok what s the address ?	as i said the address is @poi_address_11 : do you want me to navigate you there ?
4 yes , please , and thank you car !	you are welcome , drive carefully !

1 what @poi_type_1 are around ?	@poi_11 is @distance_11 away
2 what is the address ?	@poi_11 is at @poi_address_11
3 thanks	anytime

1 i need help finding a @poi_type_1	i have a listing for a @poi_type_1 named @poi_11
2 what is the address ?	the address is @poi_address_11 would you like directions there ?
3 yes , please , just pick the shortest distance	here are directions to @poi_address_11
4 thank you car !	you are welcome have a great day

1 is there a @poi_type_1 around ?	we are @distance_11 away from @poi_11 , would you like to set the gps to get there ?
2 yes , please set a quick route to go there , thank you !	it s located at @poi_address_11 and the gps is set
3 thanks	you are welcome !

1 what is @poi_type_1 address and what is the route i can take there with the least traffic that will get me there the quickest ?	the quickest route to @poi_11 located at @poi_address_11 is @distance_11 with @traffic_info_11
2 awesome , thanks	you are welcome

1 find the nearest @poi_type_1 place on the map	the closest @poi_type_1 is @poi_11 @distance_11 away
2 pick a route to avoid all @traffic_info_10 and send me its address on map please	@poi_11 is at @poi_address_11
3 thank you car , let s go there !	you are welcome and we are on our way

1 where is a @poi_type_1 at nearby ?	the closest @poi_type_1 i have is @distance_11 away and it s name is @poi_11
2 what is the address ?	the address is @poi_address_11
3 thank you !	you are welcome , happy to help

1 give me a quick route to a @poi_type_1	@poi_11 is @distance_11 away at @poi_address_11 but @traffic_info_11 is nearby
2 is there another @poi_type_1 nearby on a quick route ?	i m afraid that s the only @poi_type_1 in the area setting navigation now
3 thank you	you are welcome !

1 find a @poi_type_1	there is a @poi_12 , @poi_13 , @poi_11 and @poi_14 , which one would you like ?
2 pick for me the one with the shortest distance please	@poi_11 is @distance_11 away at @poi_address_11 , and there is currently @traffic_info_11 on the route setting directions now
3 thank you	you are welcome

1 where is the closest @poi_type_1 and what are the directions to get there the fastest ?	the closest @poi_type_1 with @traffic_info_11 is @poi_11
2 yes @poi_11 sounds great	okay , heading to @poi_11
3 thank you car , even if you didn t want to tell me the directions thank you !	you are welcome ; drive safely

1 give me directions to the nearest @poi_type_1	we are @distance_11 away from @poi_11 : does it sound good to you ?
2 yes , what is the address ?	@poi_address_11 , it s @distance_11 away but there is @traffic_info_11 on our way
3 is there another @poi_type_1 with no @traffic_info_10 ?	currently @poi_11 is the only one i have listed should i set gps anyway ?
4 i guess that will have to do , go ahead and set gps	i sent the info on your screen , drive carefully !

1 what are the directions to the nearest @poi_type_1	the nearest @poi_type_1 is @poi_11 which is @distance_11 away and it has @traffic_info_11
2 is there another option with less traffic ?	i m sorry @poi_11 is the best choice at the moment
3 okay , thank you	would you like to go there ?
4 yes please thanks	you are welcome , we should get there shortly

1 show me the locations of all @poi_type_1	there is @poi_11 @distance_11 away at @poi_address_11
2 it sounds good ! please pick the fastest possible route and send the address on my screen , thanks !	the @poi_11 is @distance_11 away with @traffic_info_11 i have set the gps
3 thank you	you are welcome

1 car i need a @poi_type_1 in the area , please find something for me	the closest @poi_type_1 is @distance_11 away and the name of it is @poi_11
2 send me the address now	its address is @poi_address_11
3 plot the quickest route to @poi_11 with details	there is a @traffic_info_11 but i sent on your screen another road that should allow you to reach the @poi_type_1 fast enough
4 that s okay , thank you car !	you are welcome !

1 can i find a @poi_type_1 ?	i have a @poi_type_1 listed at @distance_11 away
2 i need the shortest route	the @poi_11 is located @distance_11 away
3 thanks !	anytime

1 find me a nearby @poi_type_1	@poi_11 is nearby
2 what is the address ?	@poi_address_11 the @poi_11 is @distance_11 away and you should be able to reach it quickly despite the @traffic_info_11
3 sounds like a plan , thank you	you are welcome

1 how do i get to the closest @poi_type_1	there are two @poi_type_1 nearby @poi_11 and @poi_12 , which one would you prefer ?
2 please give me the address and directions to the restaurant via a route that avoids @traffic_info_10	@poi_11 is @distance_11 away at @poi_address_11 there is @traffic_info_11 setting navigation now
3 thank you	you are welcome !

1 where can i go @poi_type_1 ?	you can go @poi_type_1 at @poi_11 at @poi_address_11
2 do you have a quick route to reach it ?	it s @distance_11 away and there is @traffic_info_11 on our way , it won t be fast
3 ouch patience , then we ll enjoy some music in the meantime , open the stereo for me please thank you car !	stereo is playing " nothing else matters " now you are welcome !

1 where is the nearest @poi_type_1 located ?	@poi_11 is @distance_11 away
2 is it the quickest route ?	yes
3 then let s go there , thank you !	setting navigation to @poi_address_11 now
4 thank you car !	you are welcome

1 where is the nearest @poi_type_1 ?	the nearest is @poi_11 at @poi_address_11 would you like directions there ?
2 yes , please set directions via a route that avoids all @traffic_info_10 if possible	unfortunately there is a @traffic_info_11 but i already sent you another route that , even if longer , will allow you to reach fast enough
3 thank you car , let s go !	on our way !

1 take me @poi_type_1	sure , can you please give me the address ?
2 it should be already saved among your poi , check better !	@poi_type_1 is @distance_11 away at @poi_11
3 thanks so much	you are welcome !

1 how many @poi_type_1 are around here	i see 2 nearby @poi_type_1 including @poi_11 and @poi_12
2 give me the info for the one that has the quickest route	the quickest route is for the @poi_11 which is @distance_11 away with @traffic_info_11 the address is @poi_address_11
3 thank you	you are welcome !

1 give me directions to the local @poi_type_1	there is @poi_11 at @poi_address_11 it s @distance_11 away but there is @traffic_info_11 on the route
2 thanks	you are welcome !

1 where is the closest @poi_type_1 ?	the closest @poi_type_1 is @distance_11 away
2 what is the address ?	@poi_11 s address is @poi_address_11
3 thank you !	have a great day and happy to help

1 where can i get @poi_type_1 ?	@poi_11 is @distance_11 away and @poi_12 is @distance_12
2 what is the address of @poi_12 ?	@poi_12 is at @poi_address_12
3 is there any traffic there ?	@poi_12 has @traffic_info_12 in the route
4 okay thank you	you are welcome , have a great day

1 can you give me the address and the quickest route directions to a @poi_type_1	the only @poi_type_1 is @poi_11 at @distance_11 away
2 ok , please give me the address and directions via the shortest distance	the address is @poi_address_11 and i am setting gps presently
3 thank you	you are welcome ; drive carefully

1 i need to find a @poi_type_1 fast , we are about out	the closest @poi_type_1 is @poi_11 located @distance_11 away
2 what is the address ?	@poi_11 is located at @poi_address_11
3 let s pick the quickest route to go there , thank you car !	setting the quickest route to @poi_11 now have a good day

1 can you give me directions to the @poi_type_1	would you like to go at @poi_11 or at @poi_12 ?
2 the place with the least traffic please	there is @traffic_info_11 to @poi_11 , i will give you the directions
3 thank you !	you are welcome

1 where s the nearest @poi_type_1	the nearest @poi_type_1 is the @poi_11 , which is about @distance_11 away did you want to go there ?
2 yes please	setting gps to @poi_address_11
3 thanks for the help	you are welcome

1 directions to the nearest @poi_type_1	the nearest @poi_type_1 is @poi_11 at @poi_address_11 , @distance_11 away would you like directions there ?
2 yes , i need the fastest route	although there is a @traffic_info_11 , it is the fastest route to @poi_11 @distance_11 away
3 thank you	you are welcome

1 what @poi_type_1 are around ?	there is a @poi_11 @distance_11 away
2 what is the address ?	@poi_11 is at @poi_address_11
3 please give me the fastest route	there is @traffic_info_11 on our way , i sent its position on your screen , please drive carefully !
4 thank you car !	you are welcome

1 find the address of my closest @poi_type_1	@poi_11 is closest and the address is @poi_address_11
2 thanks !	anytime !

1 where is the closest @poi_type_1 ?	@poi_11 is @distance_11 away
2 what is the address ?	@poi_11 is located at @poi_address_11 want me to set the gps ?
3 yes set the gps to the fastest route with @traffic_info_10	there is @traffic_info_11 in our route but you should be able to reach fast enough
4 ok thanks for the help	you are welcome ; drive carefully

1 give me directions to the nearest @poi_type_1	@poi_11 is the nearest at @distance_11 away you will find it at @poi_address_11
2 thank you very much car !	please bring me there through a quick route the quickest route has @traffic_info_11 is that going to do ?
3 yes sounds good	navigation set anything else ?
4 no , thank you	you are welcome !

1 take me to @poi_type_1	setting navigation to @poi_11 , @distance_11 away in @traffic_info_11
2 confirm the address please , and give me directions via a route with @traffic_info_10 if possible	your address is @poi_address_11 , i sent on your screen the route to go back @poi_11
3 thanks !	you are welcome driver !

1 find nearest @poi_type_1	there is @poi_11 @distance_11 away : send you the coordinates on screen ?
2 send me the quickest route to @poi_11	setting quickest route to @poi_11 on gps now would you like the address ?
3 yes , please , send it on my map , thank you !	i sent the address @poi_address_11 on your map : is there anything else i could do for you ?
4 that s it , thank you very much car !	you are welcome , i m here to assist you !

1 where are the @poi_type_1 near me ?	we are @distance_11 away from @poi_11 : do you want to go there ?
2 is that the quickest route to one ?	that is only @distance_11 away with @traffic_info_11
3 thanks can you show me the address please ?	the address is @poi_address_11 , i sent it on your map may i do anything else for you ?
4 no that s it thanks for the help	you are welcome ; drive safely

1 where can i get @poi_type_1 ?	there is two @poi_type_1 nearby ; one @distance_11 away and one @distance_12 away but with a @traffic_info_12 noted your choice ?
2 let s go to the place @distance_11 away would you give me directions and an address , please ?	@poi_11 is located at @poi_address_11 sending directions to gps now
3 thanks !	anytime !

1 i need to find the shortest route to the @poi_type_1	it appears the nearest @poi_type_1 is @distance_11 away @poi_11 is located at @poi_address_11 with @traffic_info_11 noted
2 can you send me the directions ?	@poi_11 is located at @poi_address_11
3 thank you car !	i sent the route on your map you are welcome !

1 what @poi_type_1 is close ?	@poi_11 is @distance_11 away
2 please avoid all @traffic_info_10 and send me the route to get there , thank you	im sorry @poi_11 is the only @poi_type_1 i can find it is @distance_11 away through @traffic_info_11 at @poi_address_11
3 ok sounds good , set the navigation there please	you are welcome and the navigation has been set

1 please give me the address and directions to a @poi_type_1 near my current location , avoiding all @traffic_info_10	the nearest @poi_type_1 is @poi_11 that s located @distance_11 away at @poi_address_11 in this moment there is @traffic_info_11 on our way , i sent all the details on your screen
2 thank you very much car !	you are welcome !

1 what is the address of the local @poi_type_1 ?	@poi_11 is at @poi_address_11
2 thank you !	you are welcome

1 get me directions to the @poi_type_1	@poi_11 at @poi_address_11 would you like the route put on the screen ?
2 yes , please , and avoid all @traffic_info_10 if possible !	setting navigation to @poi_address_11 , @distance_11 away , now
3 thank you	you are welcome !

1 give me directions to a place to @poi_type_1	there are @poi_11 @distance_11 away , and @poi_12 @distance_12 from here which one do you prefer ?
2 give me the address of @poi_11	@poi_11 is at @poi_address_11 , it s @distance_11 away and there is @traffic_info_11 on the route
3 thanks how s the traffic to the @poi_12 ?	@poi_12 has @traffic_info_12 is that okay ?
4 give me the address to the @poi_12 instead and set the gps to the quickest route	the address of the @poi_12 is @poi_address_12 gps set to the quickest route to the @poi_12
5 thank you , car	you are welcome

1 i need the route with the shortest distance to a @poi_type_1 in the area	@poi_11 is located at @poi_address_11 it is @distance_11 away
2 can you provide me with the shortest distance to reach there ?	unfortunately there is a @traffic_info_11 but i already sent on your screen another route to reach the garage fast enough
3 thanks sounds good	drive carefully !

1 i need the quickest route to a @poi_type_1	there is @poi_11 which is currently @distance_11 away from your current location
2 is there a quick route to reach it ?	yes there is a short route , plotting the shortest route now
3 what s the address of the location ?	@poi_11 is at @poi_address_11 , @distance_11 away in @traffic_info_11 setting navigation now
4 thank you car !	you are welcome !

1 locate a nearby @poi_type_1 for me	@poi_11 is @distance_11 away
2 what is the address ?	@poi_11 is at @poi_address_11
3 thanks , set the gps there please	gps set for @poi_11
4 thank you	you are welcome

1 show me the route to @poi_type_1 s	there is 2 @poi_type_1 s locally ; one is @poi_11 that s @distance_11 away and @poi_12 that is @distance_12 away which do you prefer ?
2 pick the one with @traffic_info_10 or the least traffic route	there is @traffic_info_11 to @poi_11 , navigating now
3 thank you car !	you are very welcome !

1 what are some nearby @poi_type_1	i have one @poi_type_1 listed @distance_11 away what info would you like on it ?
2 send me its address and pick a route to avoid all @traffic_info_10 please	then we are navigating to @poi_11 , its address is @poi_address_11 there is @traffic_info_11 and you should be able to reach in just few minutes),
3 that sounds good	thank you car !, you are welcome !

1 find the shortest distance to a @poi_type_1 nearby	the nearest @poi_type_1 is at @poi_11 want more details ?
2 please	@poi_11 be found at @poi_address_11 @distance_11 away there is a @traffic_info_11
3 ok , give me directions via the shortest distance please	i sent the info on your screen , please drive carefully !
4 thank you very much !	you are welcome !

1 search for nearby @poi_type_1	we are @distance_11 away from @poi_11 with @traffic_info_11 on its direction but i m afraid this is the best option
2 ok , please give me the address and directions via a quick route	setting directions to @poi_address_11 now
3 great , thank you	you are welcome ; drive carefully , and enjoy

1 directions to the nearest takeout @poi_type_1	we are @distance_11 away from @poi_11 : does it sound good to you ?
2 sure , let s go there , just avoid all @traffic_info_10 , thanks !	i ve sent on screen the address with the quickest route , drive carefully !

1 where is the closest @poi_type_1 ?	the closest @poi_type_1 is @poi_11 found at @poi_address_11 it is @distance_11 away , but there is a @traffic_info_11
2 okay , thank you	you are welcome

1 i need directions to @poi_type_1	there is @poi_11 @distance_11 away : would it be good for you ?
2 yes , give me the address	the address to @poi_11 is @poi_address_11
3 sounds great navigate me there please	sure , i sent the info on your screen , drive carefully !

1 find me a nearby @poi_type_1	there is @poi_11 @distance_11 away : do you want me to send you its address on screen ?
2 yes sounds good	@poi_11 is located at @poi_address_11 do you want me to set the gps ?
3 yes , please , pick a quick route to go there too thank you !	i sent the info with the best route on your screen ! you are welcome !

1 where is a near @poi_type_1 ?	there are the @poi_11 @distance_11 away with @traffic_info_11 and the @poi_12 @distance_12 away with @traffic_info_12 : which one do you prefer ?
2 keen , what is the address ?	@poi_11 is at @poi_address_11
3 thanks	you are welcome !

1 where is the nearest @poi_type_1 ?	the nearest is @poi_11 located @distance_11 away do you want the address ?
2 yes , please , and pick the quickest route to get there too	@poi_address_11 , there is @traffic_info_11 and you should be able to reach there quickly
3 thanks !	you are welcome !

1 give me directions to some nearby @poi_type_1	we are @distance_11 away from @poi_11 : send you its address on screen ?
2 yes please	@poi_11 is located at @poi_address_11
3 set the navigation please	gps set for @poi_11
4 please select the quickest route	i sent you the info with the quickest route on screen , drive carefully !

1 find the nearest @poi_type_1	the nearest @poi_type_1 is @poi_11
2 please send me its address on screen and pick a route with @traffic_info_10 , thank you !	@poi_11 is at @poi_address_11
3 please set gps for route with @traffic_info_10	@poi_11 has @traffic_info_11 , can you still go there ?
4 yes , it will work fine anyway , thank you !	you are very welcome !

1 where is a nearby @poi_type_1 ?	we are @distance_11 away from @poi_11
2 how is the traffic ?	there is @traffic_info_11 near @poi_11
3 ok that works set the navigation for there	navigation set , have a great day

1 please give me the address and directions via the quickest route to a @poi_type_1	@poi_11 is @distance_11 away and there is a @traffic_info_11 you will be able to find it at @poi_address_11
2 ok , please direct me via the quickest route available	setting navigation for @poi_address_11 now drive carefully
3 thank you	you are welcome

1 where can i get @poi_type_1 ?	@poi_11 is @distance_11 away
2 please pick a route to avoid all @traffic_info_10 and let s go there , thank you	the only route to @poi_11 at @poi_address_11 has @traffic_info_11 do you still want to go there ?
3 i guess it will do , set the navigation for there please thanks for all the help	you are welcome

1 give me directions to the closest @poi_type_1	there is @poi_11 @distance_11 away : would you like to go there ?
2 what is the address ?	@poi_11 is located at @poi_address_11 do you want me to set the gps ?
3 set gps for fastest route	gps set to @poi_11 on the fastest route
4 thank you car !	you are welcome

1 i d like to know where i can get to @poi_type_1	there is a @poi_type_1 @distance_11 away named @poi_11 , would you like the address ?
2 yes please and make sure that i get the quickest route	the address is @poi_address_11 , there is @traffic_info_11 now but i ve set an alternative road to get there a little quicker
3 thank you very much car , let s go !	you are welcome !

1 car i need a @poi_type_1 closest to my position : help me please !	@poi_11 is @distance_11 away
2 is that the closest one ? if so send me the address as soon as possible	@poi_11 is at @poi_address_11
3 is that the closest one with @traffic_info_10 ? if so , give me directions	here are directions to @poi_11
4 plot the fastest route to @poi_11 with @traffic_info_10	there is @traffic_info_11 on our route but you should reach fast anyway i sent the info on your screen , drive carefully !
5 thank you car !	you are welcome !

1 i need a @poi_type_1 around here	the nearer @poi_type_1 is @poi_12 @distance_12 away but i have 2 other farther options @poi_11 and @poi_13 for you
2 which has @traffic_info_10 ?	@poi_11 is @distance_11 away at @poi_address_11 and the closest
3 thanks !	you are very welcome !

1 is there a @poi_type_1 near ?	just a @poi_11 or @poi_12
2 which one has the closest and quickest route ?	@poi_11 is just @distance_11 away and it has @traffic_info_11 while @poi_12 is farther and has more traffic on its way
3 what is the address for @poi_11 ?	the address for @poi_11 is @poi_address_11
4 thank you	you are welcome , have a good day

1 find me a @poi_type_1 nearby	there is @poi_11 @distance_11 away and @poi_12 in @distance_12 : which one do you prefer ?
2 can i have the address of a @poi_11 ?	sure ! the @poi_11 is at @poi_address_11 , it s just @distance_11 away with @traffic_info_11 on our route
3 thank you ! let s go there	you are welcome , navigation set

1 find me a @poi_type_1 around me	there is a @poi_type_1 @distance_11 away at @poi_address_11 but a road block is noted nearby
2 ok , please give me directions to travel the shortest distance	ok , setting navigation to the @poi_11 now
3 thank you car assitant	you are welcome my driver !

1 are there @poi_type_1 nearby	there is a @poi_11 nearby
2 what is the address ?	@poi_11 is located at @poi_address_11
3 thanks !	anytime !

1 can you please take me to a @poi_type_1	you best is @distance_11 away at @poi_11 located at @poi_address_11
2 what is the traffic like , and can you send me directions ?	there is @traffic_info_11 on the way to @poi_11 at @poi_address_11 anything else ?
3 that s is , please set the gps to go there , thank you !	setting route
4 thanks ,	you are welcome

1 find nearest @poi_type_1	the nearest @poi_type_1 is @poi_11
2 could you give me the address please , and the distance from here ?	@poi_11 is @distance_11 away at @poi_address_11
3 thank you how is the traffic there ?	there is currently @traffic_info_11 on the route
4 ok , please set gps and navigate there	gps is set and we are now enroute
5 thank you , car	you are welcome

1 where can i get @poi_type_1 ?	@poi_11 and @poi_12 are both close
2 which one has the shortest distance ?	@poi_11 is closer
3 okay great , can i have the address ?	sure , the address is @poi_address_11 , we are @distance_11 away , i sent its position on your map
4 thank you car !	you are welcome

1 car i need a @poi_type_1 within @distance_11	the @poi_11 is only @distance_11 away would you like directions ?
2 sounds great	the @poi_11 is located at @poi_address_11 setting navigation details now
3 will there be any traffic ?	there is a @traffic_info_11 , so please drive carefully
4 thank you car !	you are welcome ; drive safely

1 where is the nearest @poi_type_1 ?	@poi_11 is the only @poi_type_1 i can find it is located at @poi_address_11 which is @distance_11 away , but there is a @traffic_info_11
2 oh no i have to get there , what s the address ?	the address is @poi_address_11 , i sent the best route on your screen
3 thank you	no problem , have a good day

1 where can i find a @poi_type_1 ?	the @poi_11 is close
2 what is the address ?	@poi_11 is at @poi_address_11
3 ok program the fastest route please	gps set to @poi_11 at @poi_address_11
4 thank you	you are welcome

1 are there any @poi_type_1 near me	@poi_11 is @distance_11 away
2 please pick the quickest route and send it on my map , thank you !	here is the quickest route to @poi_11
3 what is the address ?	@poi_11 is located at @poi_address_11
4 thanks so much for the help	you are welcome

1 car i m desiring some @poi_type_1	we are @distance_11 away from @poi_11 and there is also @poi_12 @distance_12 away : which one do you prefer ?
2 i want the route that is the quickest and has the least traffic	then i suggest you @poi_11 , it s only @distance_11 away and with @traffic_info_11 on our way would you like me to set the navigation there ?
3 yes , set the navigation to @poi_11 please	i sent all the directions on your screen , enjoy your trip !
4 thank you car !	you are welcome driver !

1 car i need to get to my @poi_type_1 , it should be within @distance_11 from here	@poi_11 is @distance_11 away at @poi_address_11
2 set my navigation to @poi_type_1 for the shortest route possible	setting navigation now
3 thanks	you are welcome and be careful

1 i need the fastest route to the @poi_type_1	nearest @poi_type_1 is located at @poi_address_11 called @poi_11
2 ok , please give me directions via the fastest route	we are @distance_11 away and there is @traffic_info_11 on our way , i sent the route on your map
3 thanks for the information	you are welcome !

1 find me @poi_type_1	there is a @poi_11 near
2 how close is it to me ?	@poi_11 is @distance_11 away with @traffic_info_11 it is located at @poi_address_11
3 thank you	you are welcome , happy to help

#